    A Dream Scented in Wheat - 麦の香り漂う夢

    A Grounded Ascent - 大地より天を目指して

    A Secret Vow - 秘密の誓い

    A Thankless Coronation - 報われぬ戴冠

    A Trail of Bygone Blood - 古より受け継がれる血

    Adversarial - 相抗

    After the Charmony Fall - 調和が沈黙した後

    Along the Passing Shore - 流れ逝く岸を歩いて

    Amber - 琥珀

    An Instant Before A Gaze - その一刻、目に焼き付けて

    Arrows - 矢じり

    Baptism of Pure Thought - 純粋なる思惟の洗礼

    Before Dawn - 夜明け前

    Before the Tutorial Mission Starts - 初めてのクエストの前に

    Boundless Choreo - 終わりなき舞踏

    Brighter Than the Sun - 陽光より輝くもの

    But the Battle Isn't Over - だが戦争は終わらない

    Carve the Moon, Weave the Clouds - 彫月裁雲の意

    Chorus - 斉頌

    Collapsing Sky - 天傾

    Concert for Two - 二人だけのコンサート

    Cornucopia - 物穣

    Cruising in the Stellar Sea - 星海巡航

    Dance at Sunset - 夕日に舞う

    Dance! Dance! Dance! - ダンス！ダンス！ダンス！

    Darting Arrow - 離弦

    Data Bank - アーカイブ

    Day One of My New Life - 余生の初日

    Defense - 防衛

    Destiny's Threads Forewoven - 運命を紡ぐ糸

    Dream's Montage - 夢のモンタージュ

    Dreamville Adventure - ドリームタウンの大冒険

    Earthly Escapade - 人生は遊び

    Echoes of the Coffin - 棺のこだま

    Epoch Etched in Golden Blood - 黄金の血で刻む時代

    Eternal Calculus - 絶え間ない演算

    Eyes of the Prey - 獲物の視線

    Fermata - フェルマータ

    Final Victor - 最後の勝者

    Fine Fruit - 嘉果

    Flame of Blood, Blaze My Path - 前途燃やす血の如き炎

    Flames Afar - 烈火の彼方

    Flowing Nightglow - 光あふれる夜

    Fly Into a Pink Tomorrow - ピンク色の明日へ

    For Tomorrow's Journey - 明日のための旅

    Geniuses' Greetings - 天才たちの「挨拶」

    Geniuses' Repose - 天才たちの休息

    Good Night and Sleep Well - おやすみなさいと寝顔

    Hey, Over Here - よぉ、ここにいるぜ

    Hidden Shadow - 匿影

    Holiday Thermae Escapade - 休日のバルネア大冒険

    I Shall Be My Own Sword - この身は剣なり

    I Venture Forth to Hunt - 我が征く巡狩の道

    If Time Were a Flower - もしも時が花だったら

    In Pursuit of the Wind - 風を追う時

    In the Name of the World - 世界の名を以て

    In the Night - 夜の帳の中で

    Incessant Rain - 降りやまぬ雨

    Indelible Promise - 心に刻まれた約束

    Inherently Unjust Destiny - 運命は常に不公平

    Into the Unreachable Veil - 触れてはならぬ領域へ

    It's Showtime - ショーの始まり

    Journey, Forever Peaceful - 旅が平穏であるように

    Landau's Choice - ランドゥーの選択

    Lies Dance on the Breeze - 風に揺蕩う虚言

    Life Should Be Cast to Flames - 生命、焼滅すべし

    Long May Rainbows Adorn the Sky - 空の虹が消えぬように

    Long Road Leads Home - 長途はやがて帰途へと続く

    Loop - 淵環

    Make Farewells More Beautiful - 永訣よ美しくあれ

    Make the World Clamor - この世界に喧騒を

    Mediation - 同調

    Memories of the Past - 記憶の中の姿

    Memory's Curtain Never Falls - 尽きぬ追憶

    Meshing Cogs - 輪契

    Moment of Victory - 勝利の刹那

    Multiplication - 蕃殖

    Mutual Demise - 倶歿

    Never Forget Her Flame - 彼女の炎を忘れずに

    Night of Fright - 驚魂の夜

    Night on the Milky Way - 銀河鉄道の夜

    Ninja Record: Sound Hunt - 忍事録・音律狩猟

    Ninjutsu Inscription: Dazzling Evilbreaker - 忍法帖・繚乱破魔

    Nowhere to Run - 逃げ場なし

    On the Fall of an Aeon - とある星神の殞落を記す

    Only Silence Remains - 沈黙のみ

    Passkey - 霊鍵

    Past Self in Mirror - 鏡の中の私

    Past and Future - 過去と未来

    Patience Is All You Need - 待つのみ

    Perfect Timing - 今が丁度

    Pioneering - 新天地

    Planetary Rendezvous - 惑星との出会い

    Poised to Bloom - 美しき華よ今咲かん

    Post-Op Conversation - 手術後の会話

    Quid Pro Quo - 等価交換

    Reforged Remembrance - 時間の記憶を再構築して

    Reminiscence - 辿る記憶

    Resolution Shines As Pearls of Sweat - 決意は汗のように輝く

    Return to Darkness - 幽冥に帰す

    River Flows in Spring - 春水に初生する

    Sagacity - 見識

    Sailing Towards a Second Life - 二度目の生に向かって

    Scent Alone Stays True - 昔日の香りは今も猶

    See You at the End - 終点でまた会おう

    Shadowburn - 燃ゆる影

    Shadowed by Night - 夜は影のように付き纏う

    Shared Feeling - 同じ気持ち

    Shattered Home - 楽壊

    She Already Shut Her Eyes - 閉ざした瞳

    Sleep Like the Dead - 泥の如き眠り

    Solitary Healing - 孤独の癒やし

    Something Irreplaceable - かけがえのないもの

    Subscribe for More! - フォローして！

    Sweat Now, Cry Less - 流すなら涙より汗

    Swordplay - 論剣

    Texture of Memories - 記憶の素材

    The Birth of the Self - 「私」の誕生

    The Day The Cosmos Fell - 銀河が陥落した日

    The Flower Remembers - 花は忘れない

    The Forever Victual - 永遠の迷境ごはん

    The Great Cosmic Enterprise - 宇宙一の大商い！

    The Hell Where Ideals Burn - 理想を焼く奈落で

    The Moles Welcome You - モグラ党へようこそ

    The Seriousness of Breakfast - 朝食の儀式感

    The Story's Next Page - 物語をめくって

    The Unreachable Side - 着かない彼岸

    This Is Me! - これがウチだよ！

    This Love, Forever - 愛はいま永遠に

    Those Many Springs - 幾度目かの春

    Though Worlds Apart - 万里の山河を越えて

    Thus Burns the Dawn - 燃え盛る黎明のように

    Time Waits for No One - 時節は居らず

    Time Woven Into Gold - 光陰を織り黄金と成す

    To Evernight's Stars - 長き夜に輝く星へ

    Today Is Another Peaceful Day - 今日も平和な一日

    Trend of the Universal Market - 星間市場のトレンド

    Under the Blue Sky - 青空の下で

    Unto Tomorrow's Morrow - 明日の明日まで

    Victory In a Blink - 瞬刻の勝機

    Void - 幽邃

    Warmth Shortens Cold Nights - 暖かい夜は長くない

    We Are Wildfire - 我ら地炎

    We Will Meet Again - またお会いしましょう

    What Is Real? - 何が真か

    Whereabouts Should Dreams Rest - 夢が帰り着く場所

    Why Does the Ocean Sing - 海の歌は何がため

    Woof! Walk Time! - ワン！散歩の時間！

    Worrisome, Blissful - 悩んで笑って

    Yet Hope Is Priceless - されど希望の銘は無価