■壊滅 (Destruction)
英語名	日本語名
A Secret Vow	秘密の誓い
A Thankless Coronation	報われぬ戴冠
A Trail of Bygone Blood	古より受け継がれる血
Brighter Than the Sun	陽光より輝くもの
Collapsing Sky	天傾
Dance at Sunset	夕日に舞う
Flame of Blood, Blaze My Path	前途燃やす血の如き炎
Flames Afar	烈火の彼方
I Shall Be My Own Sword	この身は剣なり
Indelible Promise	心に刻まれた約束
Mutual Demise	倶歿
Ninja Record: Sound Hunt	忍事録・音律狩猟
Nowhere to Run	逃げ場なし
On the Fall of an Aeon	とある星神の殞落を記す
Shattered Home	楽壊
Something Irreplaceable	かけがえのないもの
The Moles Welcome You	モグラ党へようこそ
The Unreachable Side	着かない彼岸
Thus Burns the Dawn	燃え盛る黎明のように
Under the Blue Sky	青空の下で
Whereabouts Should Dreams Rest	夢が帰り着く場所
Woof! Walk Time!	ワン！散歩の時間！
■巡狩 (The Hunt)
英語名	日本語名
Adversarial	相抗
Arrows	矢じり
Baptism of Pure Thought	純粋なる思惟の洗礼
Cruising in the Stellar Sea	星海巡航
Darting Arrow	離弦
Final Victor	最後の勝者
I Venture Forth to Hunt	我が征く巡狩の道
In the Night	夜の帳の中で
Only Silence Remains	沈黙のみ
Return to Darkness	幽冥に帰す
River Flows in Spring	春水に初生する
Sailing Towards a Second Life	二度目の生に向かって
See You at the End	終点でまた会おう
Shadowed by Night	夜は影のように付き纏う
Sleep Like the Dead	泥の如き眠り
Subscribe for More!	フォローして！
Swordplay	論剣
The Hell Where Ideals Burn	理想を焼く奈落で
Worrisome, Blissful	悩んで笑って
■知恵 (Erudition)
英語名	日本語名
A Dream Scented in Wheat	麦の香り漂う夢
After the Charmony Fall	調和が沈黙した後
An Instant Before A Gaze	その一刻、目に焼き付けて
Before Dawn	夜明け前
Data Bank	アーカイブ
Eternal Calculus	絶え間ない演算
Geniuses' Repose	天才たちの休息
Into the Unreachable Veil	触れてはならぬ領域へ
Life Should Be Cast to Flames	生命、焼滅すべし
Make the World Clamor	この世界に喧噪を
Night on the Milky Way	銀河鉄道の夜
Ninjutsu Inscription: Dazzling Evilbreaker	忍法帖・繚乱破魔
Passkey	霊鍵
Sagacity	見識
The Birth of the Self	「私」の誕生
The Day The Cosmos Fell	銀河が陥落した日
The Great Cosmic Enterprise	宇宙一の大商い！
The Seriousness of Breakfast	朝食の儀式感
Today Is Another Peaceful Day	今日も平和な一日
Yet Hope Is Priceless	されど希望の銘は無価
■調和 (Harmony)
英語名	日本語名
A Grounded Ascent	大地より天を目指して
But the Battle Isn't Over	だが戦争は終わらない
Carve the Moon, Weave the Clouds	彫月裁雲の意
Chorus	斉頌
Dance! Dance! Dance!	ダンス！ダンス！ダンス！
Dreamville Adventure	ドリームタウンの大冒険
Earthly Escapade	人生は遊び
Epoch Etched in Golden Blood	黄金の血で刻む時代
Flowing Nightglow	光あふれる夜
For Tomorrow's Journey	明日のための旅
If Time Were a Flower	もしも時が花だったら
In Pursuit of the Wind	風を追う時
Mediation	同調
Memories of the Past	記憶の中の姿
Meshing Cogs	輪契
Past and Future	過去と未来
Past Self in Mirror	鏡の中の私
Planetary Rendezvous	惑星との出会い
Poised to Bloom	美しき華よ今咲かん
The Forever Victual	永遠の迷境ごはん
■虚無 (Nihility)
英語名	日本語名
Along the Passing Shore	流れ逝く岸を歩いて
Before the Tutorial Mission Starts	初めてのクエストの前に
Boundless Choreo	終わりなき舞踏
Eyes of the Prey	獲物の視線
Fermata	フェルマータ
Good Night and Sleep Well	おやすみなさいと寝顔
Hidden Shadow	匿影
Holiday Thermae Escapade	休日のバルネア大冒険
In the Name of the World	世界の名を以て
Incessant Rain	降りやまぬ雨
It's Showtime	ショーの始まり
Lies Dance on the Breeze	風に揺蕩う虚言
Long Road Leads Home	長途はやがて帰途へと続く
Loop	淵環
Never Forget Her Flame	彼女の炎を忘れずに
Patience Is All You Need	待つのみ
Reforged Remembrance	時間の記憶を再構築して
Resolution Shines As Pearls of Sweat	決意は汗のように輝く
Solitary Healing	孤独の癒し
Those Many Springs	幾度目かの春
Void	幽邃
We Will Meet Again	またお会いしましょう
Why Does the Ocean Sing	海の歌は何がため
■存護 (Preservation)
英語名	日本語名
Amber	琥珀
Concert for Two	二人だけのコンサート
Day One of My New Life	余生の初日
Defense	防衛
Destiny's Threads Forewoven	運命を紡ぐ糸
Inherently Unjust Destiny	運命は常に不公平
Journey, Forever Peaceful	旅が平穏であるように
Landau's Choice	ランドゥーの選択
Moment of Victory	勝利の刹那
Pioneering	新天地
She Already Shut Her Eyes	閉ざした瞳
Texture of Memories	記憶の素材
This Is Me!	これがウチだよ！
Though Worlds Apart	万里の山河を越えて
Trend of the Universal Market	星間市場のトレンド
We Are Wildfire	我ら地炎
■豊穣 (Abundance)
英語名	日本語名
Cornucopia	物穣
Dream's Montage	夢のモンタージュ
Echoes of the Coffin	棺のこだま
Fine Fruit	嘉果
Hey, Over Here 	「よぉ、ここにいるぜ」
Multiplication	蕃殖
Night of Fright	驚魂の夜
Perfect Timing	今が丁度
Post-Op Conversation	手術後の会話
Quid Pro Quo	等価交換
Scent Alone Stays True	昔日の香りは今も猶
Shared Feeling	同じ気持ち
Time Waits for No One	時節は居らず
Unto Tomorrow's Morrow	明日の明日まで
Warmth Shortens Cold Nights	暖かい夜は長くない
What Is Real?	何が真か

■記憶 (Remembrance)
英語名	日本語名
Fly Into a Pink Tomorrow - ピンク色の明日へ
Geniuses' Greetings - 天才たちの「挨拶」
Long May Rainbows Adorn the Sky - 空の虹が消えぬように
Make Farewells More Beautiful - 永訣よ美しくあれ
Memory's Curtain Never Falls - 尽きぬ追憶
Reminiscence - 辿る記憶
Shadowburn - 燃ゆる影
Sweat Now, Cry Less - 流すなら涙より汗
The Flower Remembers - 花は忘れない
The Story's Next Page - 物語をめくって
This Love, Forever - 愛はいま永遠に
Time Woven Into Gold - 光陰を織り黄金と成す
To Evernight's Stars - 長き夜に輝く星へ
Victory In a Blink - 瞬刻の勝機